255 255 255 255 255 255 255 255 255 255 255 255 255 255 255 255
255 255 255 255 255 255 255 255 255 255 255 255 255 255 255 255
255 255 255 255 255 255 255 255 255 255 255 255 255 255 255 255
255 255 255 255 255 255 255 255 255 255 255 255 255 255 255 255
255 255 255 255 255 255 255 255 255 255 255 255 255 255 255 255
255 255 247 254 248 242 223 253 251 242 253 220 241 252 237 246
255 252  79 190  89  65 157 203  43 158  88 117 175  72  82 204
255 170 121 105 106 213 142 102 229 151 188 190 203 104 216 255
240  76 115 201  47  63 182  52 171 147 248 254 188 139 255 255
207  59 231 165 206 105 159 227 224 171 243 156 126 253 255 255
163 187 208 120  82 228  66  83 237 142  98 209 205 255 255 255
254 254 255 254 255 255 254 255 255 255 255 255 255 255 255 255
255 255 255 255 255 255 255 255 255 255 255 255 255 255 255 255
255 255 255 255 255 255 255 255 255 255 255 255 255 255 255 255
255 255 255 255 255 255 255 255 255 255 255 255 255 255 255 255
255 255 255 255 255 255 255 255 255 255 255 255 255 255 255 255
255 255 255 255 255 255 255 255 255 255 255 255 255 255 255 255
255 255 255 255 255 255 255 255 255 255 255 255 255 255 255 255
255 255 255 255 255 255 255 255 255 255 255 255 255 255 255 255
255 255 255 255 255 255 255 255 255 255 255 255 255 255 255 255
255 255 255 255 255 255 255 255 255 255 255 255 255 255 255 255
255 255 247 254 248 242 223 253 251 242 253 220 241 252 237 246
255 252  79 190  89  65 157 203  43 158  88 117 175  72  82 204
255 171 121 105 106 213 142 102 229 151 188 190 203 104 216 255
240  76 115 202  47  63 182  52 171 147 248 254 189 139 255 255
207  59 231 165 206 105 159 227 224 171 243 156 126 253 255 255
163 187 208 120  82 228  66  83 237 142  98 209 205 255 255 255
254 254 255 254 255 255 254 255 255 255 255 255 255 255 255 255
255 255 255 255 255 255 255 255 255 255 255 255 255 255 255 255
255 255 255 255 255 255 255 255 255 255 255 255 255 255 255 255
255 255 255 255 255 255 255 255 255 255 255 255 255 255 255 255
255 255 255 255 255 255 255 255 255 255 255 255 255 255 255 255
255 255 255 255 255 255 255 255 255 255 255 255 255 255 255 255
255 255 255 255 255 255 255 255 255 255 255 255 255 255 255 255
255 255 255 255 255 255 255 255 255 255 255 255 255 255 255 255
255 255 255 255 255 255 255 255 255 255 255 255 255 255 255 255
255 255 255 255 255 255 255 255 255 255 255 255 255 255 255 255
255 255 247 254 248 242 223 253 251 242 253 220 241 252 237 246
255 252  79 190  89  65 157 203  43 158  88 117 175  72  82 204
255 170 121 105 106 213 142 102 229 151 188 190 203 104 216 255
240  76 115 201  47  63 182  52 171 147 248 254 188 139 255 255
207  59 231 165 206 105 159 227 224 171 243 156 126 253 255 255
163 187 208 120  82 228  66  83 237 142  98 209 205 255 255 255
254 254 255 254 255 255 254 255 255 255 255 255 255 255 255 255
255 255 255 255 255 255 255 255 255 255 255 255 255 255 255 255
255 255 255 255 255 255 255 255 255 255 255 255 255 255 255 255
255 255 255 255 255 255 255 255 255 255 255 255 255 255 255 255
255 255 255 255 255 255 255 255 255 255 255 255 255 255 255 255

255 255 255 255 255 246 204 255 255 255 255 255 255 255 255 255
255 255 255 255 255 237  82 216 255 255 255 255 255 255 255 255
255 255 255 255 255 252  72 104 139 253 255 255 255 255 255 255
255 255 255 255 255 241 175 203 188 126 205 255 255 255 255 255
255 255 255 255 255 220 117 190 254 156 209 255 255 255 255 255
255 255 255 255 255 253  88 188 248 243  98 255 255 255 255 255
255 255 255 255 255 242 158 151 147 171 142 255 255 255 255 255
255 255 255 255 255 251  43 229 171 224 237 255 255 255 255 255
255 255 255 255 255 253 203 102  52 227  83 255 255 255 255 255
255 255 255 255 255 223 157 142 182 159  66 254 255 255 255 255
255 255 255 255 255 242  65 213  63 105 228 255 255 255 255 255
255 255 255 255 255 248  89 106  47 206  82 255 255 255 255 255
255 255 255 255 255 254 190 105 201 165 120 254 255 255 255 255
255 255 255 255 255 247  79 121 115 231 208 255 255 255 255 255
255 255 255 255 255 255 252 170  76  59 187 254 255 255 255 255
255 255 255 255 255 255 255 255 240 207 163 254 255 255 255 255
255 255 255 255 255 246 204 255 255 255 255 255 255 255 255 255
255 255 255 255 255 237  82 216 255 255 255 255 255 255 255 255
255 255 255 255 255 252  72 104 139 253 255 255 255 255 255 255
255 255 255 255 255 241 175 203 189 126 205 255 255 255 255 255
255 255 255 255 255 220 117 190 254 156 209 255 255 255 255 255
255 255 255 255 255 253  88 188 248 243  98 255 255 255 255 255
255 255 255 255 255 242 158 151 147 171 142 255 255 255 255 255
255 255 255 255 255 251  43 229 171 224 237 255 255 255 255 255
255 255 255 255 255 253 203 102  52 227  83 255 255 255 255 255
255 255 255 255 255 223 157 142 182 159  66 254 255 255 255 255
255 255 255 255 255 242  65 213  63 105 228 255 255 255 255 255
255 255 255 255 255 248  89 106  47 206  82 255 255 255 255 255
255 255 255 255 255 254 190 105 202 165 120 254 255 255 255 255
255 255 255 255 255 247  79 121 115 231 208 255 255 255 255 255
255 255 255 255 255 255 252 171  76  59 187 254 255 255 255 255
255 255 255 255 255 255 255 255 240 207 163 254 255 255 255 255
255 255 255 255 255 246 204 255 255 255 255 255 255 255 255 255
255 255 255 255 255 237  82 216 255 255 255 255 255 255 255 255
255 255 255 255 255 252  72 104 139 253 255 255 255 255 255 255
255 255 255 255 255 241 175 203 188 126 205 255 255 255 255 255
255 255 255 255 255 220 117 190 254 156 209 255 255 255 255 255
255 255 255 255 255 253  88 188 248 243  98 255 255 255 255 255
255 255 255 255 255 242 158 151 147 171 142 255 255 255 255 255
255 255 255 255 255 251  43 229 171 224 237 255 255 255 255 255
255 255 255 255 255 253 203 102  52 227  83 255 255 255 255 255
255 255 255 255 255 223 157 142 182 159  66 254 255 255 255 255
255 255 255 255 255 242  65 213  63 105 228 255 255 255 255 255
255 255 255 255 255 248  89 106  47 206  82 255 255 255 255 255
255 255 255 255 255 254 190 105 201 165 120 254 255 255 255 255
255 255 255 255 255 247  79 121 115 231 208 255 255 255 255 255
255 255 255 255 255 255 252 170  76  59 187 254 255 255 255 255
255 255 255 255 255 255 255 255 240 207 163 254 255 255 255 255

255 255 255 255 255 255 255 255 255 255 255 255 255 255 255 255
255 255 255 255 255 255 255 255 255 255 255 255 255 255 255 255
255 255 255 255 255 255 255 255 255 255 255 255 255 255 255 255
255 255 255 255 255 255 255 255 255 255 255 255 255 255 255 255
255 255 255 255 255 255 255 255 255 254 255 255 254 255 254 254
255 255 255 205 209  98 142 237  83  66 228  82 120 208 187 163
255 255 253 126 156 243 171 224 227 159 105 206 165 231  59 207
255 255 139 188 254 248 147 171  52 182  63  47 201 115  76 240
255 216 104 203 190 188 151 229 102 142 213 106 105 121 170 255
204  82  72 175 117  88 158  43 203 157  65  89 190  79 252 255
246 237 252 241 220 253 242 251 253 223 242 248 254 247 255 255
255 255 255 255 255 255 255 255 255 255 255 255 255 255 255 255
255 255 255 255 255 255 255 255 255 255 255 255 255 255 255 255
255 255 255 255 255 255 255 255 255 255 255 255 255 255 255 255
255 255 255 255 255 255 255 255 255 255 255 255 255 255 255 255
255 255 255 255 255 255 255 255 255 255 255 255 255 255 255 255
255 255 255 255 255 255 255 255 255 255 255 255 255 255 255 255
255 255 255 255 255 255 255 255 255 255 255 255 255 255 255 255
255 255 255 255 255 255 255 255 255 255 255 255 255 255 255 255
255 255 255 255 255 255 255 255 255 255 255 255 255 255 255 255
255 255 255 255 255 255 255 255 255 254 255 255 254 255 254 254
255 255 255 205 209  98 142 237  83  66 228  82 120 208 187 163
255 255 253 126 156 243 171 224 227 159 105 206 165 231  59 207
255 255 139 189 254 248 147 171  52 182  63  47 202 115  76 240
255 216 104 203 190 188 151 229 102 142 213 106 105 121 171 255
204  82  72 175 117  88 158  43 203 157  65  89 190  79 252 255
246 237 252 241 220 253 242 251 253 223 242 248 254 247 255 255
255 255 255 255 255 255 255 255 255 255 255 255 255 255 255 255
255 255 255 255 255 255 255 255 255 255 255 255 255 255 255 255
255 255 255 255 255 255 255 255 255 255 255 255 255 255 255 255
255 255 255 255 255 255 255 255 255 255 255 255 255 255 255 255
255 255 255 255 255 255 255 255 255 255 255 255 255 255 255 255
255 255 255 255 255 255 255 255 255 255 255 255 255 255 255 255
255 255 255 255 255 255 255 255 255 255 255 255 255 255 255 255
255 255 255 255 255 255 255 255 255 255 255 255 255 255 255 255
255 255 255 255 255 255 255 255 255 255 255 255 255 255 255 255
255 255 255 255 255 255 255 255 255 254 255 255 254 255 254 254
255 255 255 205 209  98 142 237  83  66 228  82 120 208 187 163
255 255 253 126 156 243 171 224 227 159 105 206 165 231  59 207
255 255 139 188 254 248 147 171  52 182  63  47 201 115  76 240
255 216 104 203 190 188 151 229 102 142 213 106 105 121 170 255
204  82  72 175 117  88 158  43 203 157  65  89 190  79 252 255
246 237 252 241 220 253 242 251 253 223 242 248 254 247 255 255
255 255 255 255 255 255 255 255 255 255 255 255 255 255 255 255
255 255 255 255 255 255 255 255 255 255 255 255 255 255 255 255
255 255 255 255 255 255 255 255 255 255 255 255 255 255 255 255
255 255 255 255 255 255 255 255 255 255 255 255 255 255 255 255
255 255 255 255 255 255 255 255 255 255 255 255 255 255 255 255

255 255 255 255 254 163 207 240 255 255 255 255 255 255 255 255
255 255 255 255 254 187  59  76 170 252 255 255 255 255 255 255
255 255 255 255 255 208 231 115 121  79 247 255 255 255 255 255
255 255 255 255 254 120 165 201 105 190 254 255 255 255 255 255
255 255 255 255 255  82 206  47 106  89 248 255 255 255 255 255
255 255 255 255 255 228 105  63 213  65 242 255 255 255 255 255
255 255 255 255 254  66 159 182 142 157 223 255 255 255 255 255
255 255 255 255 255  83 227  52 102 203 253 255 255 255 255 255
255 255 255 255 255 237 224 171 229  43 251 255 255 255 255 255
255 255 255 255 255 142 171 147 151 158 242 255 255 255 255 255
255 255 255 255 255  98 243 248 188  88 253 255 255 255 255 255
255 255 255 255 255 209 156 254 190 117 220 255 255 255 255 255
255 255 255 255 255 205 126 188 203 175 241 255 255 255 255 255
255 255 255 255 255 255 253 139 104  72 252 255 255 255 255 255
255 255 255 255 255 255 255 255 216  82 237 255 255 255 255 255
255 255 255 255 255 255 255 255 255 204 246 255 255 255 255 255
255 255 255 255 254 163 207 240 255 255 255 255 255 255 255 255
255 255 255 255 254 187  59  76 171 252 255 255 255 255 255 255
255 255 255 255 255 208 231 115 121  79 247 255 255 255 255 255
255 255 255 255 254 120 165 202 105 190 254 255 255 255 255 255
255 255 255 255 255  82 206  47 106  89 248 255 255 255 255 255
255 255 255 255 255 228 105  63 213  65 242 255 255 255 255 255
255 255 255 255 254  66 159 182 142 157 223 255 255 255 255 255
255 255 255 255 255  83 227  52 102 203 253 255 255 255 255 255
255 255 255 255 255 237 224 171 229  43 251 255 255 255 255 255
255 255 255 255 255 142 171 147 151 158 242 255 255 255 255 255
255 255 255 255 255  98 243 248 188  88 253 255 255 255 255 255
255 255 255 255 255 209 156 254 190 117 220 255 255 255 255 255
255 255 255 255 255 205 126 189 203 175 241 255 255 255 255 255
255 255 255 255 255 255 253 139 104  72 252 255 255 255 255 255
255 255 255 255 255 255 255 255 216  82 237 255 255 255 255 255
255 255 255 255 255 255 255 255 255 204 246 255 255 255 255 255
255 255 255 255 254 163 207 240 255 255 255 255 255 255 255 255
255 255 255 255 254 187  59  76 170 252 255 255 255 255 255 255
255 255 255 255 255 208 231 115 121  79 247 255 255 255 255 255
255 255 255 255 254 120 165 201 105 190 254 255 255 255 255 255
255 255 255 255 255  82 206  47 106  89 248 255 255 255 255 255
255 255 255 255 255 228 105  63 213  65 242 255 255 255 255 255
255 255 255 255 254  66 159 182 142 157 223 255 255 255 255 255
255 255 255 255 255  83 227  52 102 203 253 255 255 255 255 255
255 255 255 255 255 237 224 171 229  43 251 255 255 255 255 255
255 255 255 255 255 142 171 147 151 158 242 255 255 255 255 255
255 255 255 255 255  98 243 248 188  88 253 255 255 255 255 255
255 255 255 255 255 209 156 254 190 117 220 255 255 255 255 255
255 255 255 255 255 205 126 188 203 175 241 255 255 255 255 255
255 255 255 255 255 255 253 139 104  72 252 255 255 255 255 255
255 255 255 255 255 255 255 255 216  82 237 255 255 255 255 255
255 255 255 255 255 255 255 255 255 204 246 255 255 255 255 255
